0000000000000000000000000000000000000000000000000000000000000000
0000000000000000000000000000000000000000000000000000000000000000
0000000000000000000000000000000000000000000000000000000000000000
0000000000000000000000000000000000000000000000000000000000000000
0000000000000000000000000000000000000000000000000000000000000000
0000000000000000000000000000000000000000000000000000000000000000
0000000000000000000000000000000000000000000000000000000000000000
0000000000000000000000000000000000000000000000000000000000000000
0000000000000000000000000000000000000000000000000000000000000000
0000000000000000000000000000000000000000000000000000000000000000
0000000000000000000000000000000000000000000000000000000000000000
0000000000000000000000000000000000000000000000000000000000000000
0000000000000000000000000000000000000000000000000000000000000000
0000000000000000000000000000000000000000000000000000000000000000
0000000000000000000000000000000000000000000000000000000000000000
0000000000000000000000000000000000000000000000000000000000000000
0000000000000000000000000000000000000000000000000000000000000000
0000000000000000000000000000000000000000000000000000000000000000
0000000000000000000000000000000000000000000000000000000000000000
0000000001110001110000000000000000000000000000000000000000000000
0000000001110001110000000000000000000000000000000000000000000000
0000000001110001110000000000000000000000000000000000000000000000
0000000001110001110000000000000000000000000000000000000000000000
0000000000000000000000000000000000000000000000000000000000000000
0000000000000000000000000000001110000000000000000000000000000000
0000000000000000001000000000011110000000000000000000000000000000
0000000000000000001000000000011111000000000000000000000000000000
0000000011000000001000000000111111000000000000000000000000000000
0000000011000000011000000000111111111000000000000000000000000000
0000000011000000010000000001111111111000000000000000000000000000
0000000011000000110000000111111111111000000000000000000000000000
0000000001000000100000000111111111111100000000000000000000000000
0000000001100001100000111111111111111111000000000000000000000000
0000000000110011000001111111111111111111100000000000000000000000
0000000000111110000001111111111111111111111110000000000000000000
0000000000000000000011111111111111111111111111000000000000000000
0000000000000000000001111111111111111111111111000000000000000000
0000000000000000000000000000011111111111111111000000000000000000
0000000000000000000000000000011111111111111111000000000000000000
0000000000000000000000000000000111111111111111000000000000000000
0000000000000000000000000000000011111111111111000000000000000000
0000000000000000000000000000000000000000111111000000000000000000
0000000000000000000000000000000000000000111111000000000000000000
0000000000000000000000000000000000000000011111000000000000000000
0000000000000000000000000000000000000000011111000000000000000000
0000000000000000000000000000000000000000001111000000000000000000
0000000000000000000000000000000000000000000111000000000000000000
0000000000000000000000000000000000000000000001000000000000000000
0000000000000000000000000000000000000000000000000000000000000000
0000000000000000000000000000000000000000000000000000000000000000
0000000000000000000000000000000000000000000000000000000000000000
0000000000000000000000000000000000000000000000000000000000000000
0000000000000000000000000000000000000000000000000000000000000000
0000000000000000000000000000000000000000000000000000000000000000
0000000000000000000000000000000000000000000000000000000000000000
0000000000000000000000000000000000000000000000000000000000000000
0000000000000000000000000000000000000000000000000000000000000000
0000000000000000000000000000000000000000000000000000000000000000
0000000000000000000000000000000000000000000000000000000000000000
0000000000000000000000000000000000000000000000000000000000000000
0000000000000000000000000000000000000000000000000000000000000000
0000000000000000000000000000000000000000000000000000000000000000
0000000000000000000000000000000000000000000000000000000000000000
0000000000000000000000000000000000000000000000000000000000000000
